[
[28, 20, 20, 20, 20, 20, 20, 20, 20, 20, 20, 20, 20, 20, 20, 20, 20, 20, 20, 20, 20, 20, 20, 20, 20, 20, 20, 20, 20, 20, 20, 20, 20, 20, 20, 20, 20, 20, 20, 20, 20, 20, 20, 20, 20, 20, 20, 20, 20, 20, 20, 20, 20, 20, 20, 20, 20, 20, 20, 29],
[13, 0, 0, 0, 0, 0, 0, 0, 0, 0, 0, 0, 0, 0, 0, 0, 0, 0, 0, 0, 0, 0, 0, 0, 0, 0, 0, 0, 0, 0, 0, 0, 0, 0, 0, 0, 0, 0, 0, 0, 0, 0, 0, 0, 0, 0, 0, 0, 0, 0, 0, 0, 0, 0, 0, 0, 0, 0, 0, 10],
[13, 55, 0, 0, 0, 0, 0, 0, 47, 0, 0, 0, 6, 0, 0, 47, 0, 0, 7, 0, 0, 47, 0, 0, 0, 0, 8, 0, 0, 47, 0, 0, 0, 7, 0, 47, 0, 0, 5, 0, 47, 0, 6, 0, 0, 8, 0, 0, 0, 0, 0, 5, 0, 0, 0, 0, 0, 0, 0, 10],
[13, 23, 24, 24, 24, 24, 24, 24, 24, 24, 24, 24, 24, 24, 24, 24, 24, 24, 24, 24, 24, 24, 24, 24, 24, 24, 24, 24, 24, 24, 24, 24, 24, 24, 24, 24, 24, 24, 24, 24, 24, 24, 24, 24, 24, 24, 24, 24, 24, 24, 24, 24, 24, 24, 26, 0, 0, 0, 0, 10],
[13, 0, 0, 0, 0, 0, 0, 0, 0, 0, 0, 0, 0, 0, 0, 0, 0, 0, 0, 0, 0, 0, 0, 0, 0, 0, 0, 0, 0, 0, 0, 0, 0, 0, 0, 0, 0, 0, 0, 1, 4, 0, 0, 0, 0, 0, 0, 0, 0, 0, 0, 0, 0, 0, 0, 0, 0, 0, 0, 10],
[13, 0, 0, 0, 0, 0, 0, 0, 0, 0, 0, 0, 0, 0, 0, 0, 0, 0, 0, 0, 0, 0, 0, 0, 0, 0, 0, 0, 0, 0, 0, 0, 0, 0, 0, 0, 0, 0, 0, 10, 13, 0, 0, 0, 0, 0, 0, 0, 0, 0, 0, 0, 0, 0, 0, 0, 0, 54, 0, 10],
[13, 0, 0, 0, 0, 0, 0, 0, 0, 0, 0, 0, 0, 0, 0, 0, 0, 0, 0, 0, 0, 0, 0, 0, 0, 0, 0, 0, 0, 0, 0, 0, 0, 0, 0, 0, 0, 0, 0, 10, 13, 0, 5, 47, 0, 8, 0, 0, 0, 47, 0, 0, 0, 0, 54, 0, 0, 23, 26, 10],
[13, 0, 0, 36, 1, 4, 0, 0, 23, 24, 25, 24, 25, 24, 25, 24, 25, 24, 25, 24, 25, 24, 25, 24, 25, 24, 25, 24, 25, 24, 25, 24, 25, 24, 25, 26, 0, 0, 0, 10, 13, 23, 24, 24, 24, 24, 24, 24, 24, 24, 24, 24, 24, 24, 26, 0, 0, 0, 0, 10],
[13, 54, 0, 0, 10, 13, 0, 0, 0, 0, 0, 0, 0, 0, 0, 0, 0, 0, 0, 9, 9, 0, 0, 0, 0, 0, 0, 0, 0, 0, 0, 0, 0, 0, 0, 0, 0, 0, 54, 10, 13, 0, 0, 0, 0, 0, 0, 0, 0, 0, 0, 0, 0, 0, 0, 0, 0, 0, 0, 10],
[13, 36, 0, 0, 10, 13, 54, 0, 0, 0, 0, 0, 0, 0, 0, 0, 0, 0, 0, 18, 18, 0, 0, 0, 0, 0, 0, 0, 0, 0, 0, 0, 0, 0, 0, 0, 0, 0, 36, 10, 13, 0, 0, 0, 8, 0, 0, 47, 0, 0, 0, 47, 0, 0, 0, 0, 54, 0, 0, 10],
[13, 0, 0, 0, 10, 13, 36, 0, 49, 49, 51, 51, 51, 58, 58, 58, 59, 59, 59, 18, 18, 6, 7, 0, 0, 47, 0, 47, 0, 0, 0, 47, 0, 0, 0, 0, 0, 0, 0, 19, 22, 23, 25, 25, 25, 24, 24, 24, 24, 25, 24, 24, 24, 24, 25, 25, 26, 0, 0, 10],
[13, 0, 0, 54, 10, 13, 0, 0, 23, 24, 24, 24, 24, 24, 24, 24, 24, 24, 26, 27, 27, 23, 24, 25, 24, 25, 24, 25, 24, 25, 24, 25, 24, 25, 24, 25, 26, 0, 0, 0, 0, 0, 0, 0, 0, 0, 0, 0, 0, 0, 0, 0, 0, 0, 0, 0, 0, 0, 0, 10],
[13, 0, 0, 36, 10, 13, 0, 0, 0, 0, 0, 0, 0, 0, 0, 0, 0, 0, 0, 0, 0, 0, 0, 0, 0, 0, 0, 0, 0, 0, 0, 0, 0, 0, 0, 0, 0, 0, 0, 0, 0, 0, 0, 0, 0, 0, 7, 0, 0, 8, 0, 0, 0, 0, 0, 0, 0, 47, 54, 10],
[13, 0, 0, 0, 10, 13, 0, 0, 0, 0, 0, 0, 0, 0, 0, 0, 0, 0, 0, 0, 0, 0, 0, 0, 0, 0, 0, 0, 0, 0, 0, 0, 0, 0, 0, 0, 0, 0, 54, 14, 17, 23, 24, 25, 24, 25, 24, 25, 24, 25, 24, 25, 24, 25, 24, 25, 25, 25, 26, 10],
[13, 54, 0, 0, 10, 13, 0, 0, 0, 0, 0, 0, 0, 0, 0, 0, 0, 0, 0, 0, 0, 0, 0, 0, 0, 0, 0, 0, 0, 1, 15, 16, 15, 16, 15, 16, 15, 16, 4, 10, 13, 0, 0, 0, 0, 0, 0, 0, 0, 0, 0, 0, 0, 0, 0, 0, 0, 0, 0, 10],
[13, 36, 0, 0, 10, 13, 59, 59, 47, 7, 0, 47, 0, 47, 0, 0, 0, 0, 0, 0, 0, 0, 0, 46, 0, 0, 0, 54, 0, 19, 20, 20, 20, 20, 20, 20, 20, 20, 22, 10, 13, 0, 0, 0, 0, 0, 0, 0, 0, 0, 0, 0, 0, 0, 0, 0, 0, 0, 0, 10],
[13, 0, 0, 0, 10, 13, 23, 24, 25, 24, 25, 24, 25, 24, 25, 24, 25, 24, 25, 0, 0, 0, 23, 24, 25, 24, 25, 26, 0, 0, 0, 0, 0, 0, 0, 0, 0, 0, 0, 10, 13, 0, 0, 0, 0, 0, 0, 0, 0, 0, 0, 0, 0, 0, 0, 0, 0, 0, 0, 10],
[13, 0, 0, 54, 10, 13, 0, 0, 0, 0, 0, 0, 0, 0, 0, 0, 0, 0, 0, 0, 0, 0, 0, 0, 0, 0, 0, 0, 0, 0, 0, 0, 0, 0, 0, 0, 0, 0, 0, 19, 22, 0, 0, 0, 0, 0, 0, 0, 0, 0, 0, 0, 0, 0, 0, 0, 0, 0, 0, 10],
[13, 0, 0, 36, 10, 13, 0, 0, 0, 0, 0, 0, 0, 0, 47, 0, 0, 0, 0, 0, 54, 0, 0, 0, 0, 0, 0, 0, 0, 0, 0, 0, 0, 0, 0, 0, 0, 0, 0, 0, 0, 0, 0, 0, 0, 0, 0, 0, 0, 0, 0, 0, 0, 0, 0, 0, 0, 0, 0, 10],
[13, 0, 0, 0, 10, 13, 0, 0, 0, 0, 7, 23, 25, 25, 25, 25, 25, 25, 25, 25, 25, 25, 25, 25, 25, 25, 25, 26, 9, 0, 0, 0, 0, 0, 0, 0, 0, 0, 0, 0, 0, 0, 0, 7, 0, 0, 0, 7, 0, 47, 0, 5, 0, 0, 8, 0, 0, 0, 0, 10],
[13, 54, 0, 0, 10, 13, 0, 0, 0, 23, 26, 9, 0, 0, 0, 0, 0, 0, 0, 0, 0, 0, 0, 0, 0, 0, 0, 0, 18, 0, 0, 6, 23, 25, 25, 25, 25, 25, 26, 14, 17, 23, 24, 24, 24, 24, 24, 24, 24, 24, 24, 24, 24, 24, 25, 26, 0, 0, 0, 10],
[13, 36, 0, 0, 10, 13, 36, 0, 0, 0, 0, 18, 58, 47, 0, 47, 51, 7, 0, 0, 0, 0, 0, 0, 46, 59, 46, 59, 18, 0, 0, 23, 24, 24, 24, 24, 24, 24, 26, 10, 13, 0, 0, 0, 0, 0, 0, 0, 0, 0, 0, 0, 0, 0, 0, 0, 0, 0, 0, 10],
[13, 0, 0, 0, 10, 13, 23, 26, 0, 0, 0, 27, 23, 24, 24, 24, 24, 24, 26, 0, 0, 0, 23, 24, 25, 24, 25, 26, 18, 0, 0, 0, 0, 0, 0, 0, 0, 0, 0, 10, 13, 0, 0, 0, 47, 0, 47, 0, 0, 46, 0, 5, 46, 0, 6, 0, 0, 54, 0, 10],
[13, 0, 0, 0, 10, 13, 23, 24, 26, 6, 0, 0, 0, 0, 0, 0, 0, 0, 0, 0, 0, 0, 0, 0, 0, 0, 0, 0, 18, 0, 0, 0, 0, 0, 0, 0, 0, 0, 0, 10, 13, 0, 0, 23, 24, 24, 24, 24, 24, 24, 24, 24, 24, 24, 24, 24, 25, 26, 0, 10],
[13, 56, 7, 54, 19, 22, 23, 24, 25, 26, 7, 0, 0, 0, 0, 0, 0, 0, 0, 0, 54, 0, 0, 0, 0, 0, 0, 0, 27, 54, 0, 47, 0, 0, 0, 0, 0, 0, 0, 10, 13, 0, 0, 0, 0, 0, 0, 0, 0, 0, 0, 0, 0, 0, 0, 0, 0, 0, 0, 10],
[13, 2, 2, 1, 2, 2, 2, 2, 2, 2, 2, 2, 2, 2, 2, 2, 2, 2, 2, 2, 2, 2, 2, 2, 2, 2, 2, 2, 2, 2, 2, 2, 2, 2, 3, 4, 0, 0, 0, 10, 13, 59, 59, 46, 59, 46, 0, 6, 0, 46, 0, 46, 0, 0, 0, 0, 0, 0, 0, 10],
[13, 0, 0, 19, 20, 20, 20, 20, 20, 20, 20, 20, 20, 20, 20, 20, 20, 20, 20, 20, 20, 20, 20, 20, 20, 20, 20, 20, 20, 20, 20, 20, 20, 20, 20, 22, 0, 0, 0, 10, 13, 23, 24, 24, 24, 24, 24, 24, 24, 24, 24, 24, 24, 24, 26, 0, 0, 0, 0, 10],
[13, 0, 0, 0, 0, 0, 0, 0, 0, 0, 0, 0, 0, 0, 0, 0, 0, 0, 0, 0, 0, 0, 0, 0, 0, 0, 0, 0, 0, 0, 0, 0, 0, 0, 0, 0, 0, 0, 0, 10, 13, 0, 0, 0, 0, 0, 0, 0, 0, 0, 0, 0, 0, 0, 0, 0, 0, 0, 0, 10],
[13, 5, 60, 0, 0, 6, 0, 0, 5, 0, 0, 0, 0, 47, 0, 0, 0, 0, 46, 0, 0, 47, 0, 58, 59, 59, 0, 8, 0, 47, 0, 0, 0, 47, 0, 0, 0, 49, 54, 19, 22, 50, 47, 59, 47, 0, 49, 47, 0, 47, 0, 0, 47, 8, 0, 0, 0, 51, 51, 10],
[37, 15, 15, 15, 15, 15, 15, 15, 15, 15, 15, 15, 15, 15, 15, 15, 15, 15, 15, 15, 15, 15, 15, 15, 15, 15, 15, 15, 15, 15, 15, 15, 15, 15, 15, 15, 15, 15, 15, 15, 15, 15, 15, 15, 15, 15, 15, 15, 15, 15, 15, 15, 15, 15, 15, 15, 15, 15, 16, 38]
]