[
[14, 25, 25, 25, 25, 25, 25, 25, 25, 25, 25, 25, 25, 25, 25, 25, 25, 25, 25, 25, 25, 25, 25, 25, 25, 25, 25, 25, 25, 25, 25, 25, 25, 25, 25, 25, 25, 25, 25, 25, 25, 25, 25, 25, 25, 25, 25, 25, 25, 17],
[18, 0, 0, 0, 0, 0, 0, 0, 0, 0, 0, 0, 0, 0, 0, 0, 0, 0, 0, 0, 0, 0, 0, 0, 0, 0, 0, 0, 0, 0, 0, 0, 0, 0, 0, 0, 0, 0, 0, 0, 0, 0, 0, 0, 0, 0, 0, 0, 0, 18],
[18, 0, 0, 0, 0, 0, 0, 0, 0, 0, 0, 0, 0, 0, 0, 0, 0, 0, 0, 0, 0, 0, 0, 0, 0, 0, 0, 0, 0, 0, 0, 0, 0, 0, 0, 0, 0, 0, 0, 0, 0, 0, 0, 0, 0, 0, 0, 0, 0, 18],
[18, 0, 0, 0, 0, 0, 0, 0, 0, 0, 0, 0, 0, 0, 0, 0, 0, 0, 0, 0, 0, 0, 0, 0, 0, 0, 0, 0, 0, 0, 0, 0, 0, 0, 0, 0, 0, 7, 46, 50, 0, 48, 0, 0, 5, 46, 0, 0, 0, 18],
[18, 0, 0, 0, 0, 0, 0, 0, 0, 0, 0, 0, 0, 0, 0, 0, 0, 0, 0, 0, 0, 0, 0, 0, 0, 0, 0, 0, 0, 0, 0, 0, 0, 0, 0, 23, 24, 24, 24, 24, 24, 25, 25, 25, 25, 25, 26, 0, 0, 18],
[18, 0, 0, 0, 0, 0, 0, 0, 0, 0, 0, 0, 0, 0, 0, 0, 0, 0, 0, 46, 0, 5, 0, 0, 0, 0, 0, 0, 0, 0, 0, 0, 0, 0, 0, 0, 0, 0, 0, 0, 0, 0, 0, 0, 0, 0, 0, 0, 0, 18],
[18, 0, 0, 0, 0, 0, 0, 0, 0, 0, 5, 46, 0, 0, 0, 0, 14, 2, 3, 2, 3, 2, 17, 0, 0, 0, 0, 0, 0, 0, 0, 0, 0, 0, 0, 0, 0, 0, 0, 0, 0, 0, 0, 0, 0, 0, 0, 53, 0, 18],
[18, 0, 0, 0, 0, 46, 48, 49, 1, 3, 2, 3, 2, 17, 0, 0, 19, 20, 21, 20, 20, 21, 22, 0, 0, 0, 0, 0, 0, 0, 0, 0, 0, 0, 0, 0, 5, 0, 0, 0, 46, 6, 0, 0, 0, 0, 1, 4, 0, 18],
[18, 0, 0, 23, 24, 25, 25, 25, 10, 11, 12, 11, 12, 13, 0, 0, 0, 0, 0, 9, 0, 0, 0, 0, 0, 0, 0, 0, 53, 0, 0, 0, 0, 1, 2, 3, 2, 3, 2, 3, 2, 3, 2, 3, 4, 0, 10, 13, 0, 18],
[18, 0, 0, 0, 0, 0, 0, 0, 19, 20, 21, 20, 21, 22, 0, 0, 0, 0, 0, 18, 0, 0, 0, 0, 0, 0, 0, 0, 36, 0, 0, 0, 0, 0, 0, 0, 0, 0, 0, 0, 0, 0, 0, 0, 0, 0, 10, 13, 0, 18],
[18, 0, 0, 0, 0, 0, 0, 0, 0, 0, 0, 0, 0, 0, 0, 0, 0, 0, 0, 18, 0, 0, 0, 0, 0, 0, 0, 0, 0, 0, 0, 0, 0, 0, 0, 0, 0, 0, 0, 0, 0, 0, 0, 0, 0, 0, 10, 13, 0, 18],
[18, 0, 0, 0, 0, 0, 0, 0, 0, 0, 0, 0, 0, 0, 0, 0, 0, 0, 0, 18, 0, 0, 0, 0, 0, 0, 0, 0, 0, 0, 0, 0, 0, 0, 0, 0, 0, 0, 0, 0, 0, 0, 0, 0, 0, 0, 10, 13, 0, 18],
[18, 0, 0, 0, 0, 0, 0, 0, 0, 0, 0, 0, 0, 0, 0, 0, 0, 0, 5, 27, 5, 50, 0, 0, 0, 0, 53, 0, 0, 0, 0, 0, 0, 0, 0, 0, 0, 0, 0, 0, 0, 5, 0, 0, 46, 7, 10, 13, 0, 18],
[18, 53, 0, 0, 0, 0, 0, 0, 0, 0, 0, 0, 0, 0, 0, 0, 23, 25, 25, 25, 25, 25, 26, 0, 0, 0, 36, 0, 0, 0, 0, 0, 0, 0, 0, 0, 0, 0, 0, 0, 1, 2, 3, 3, 2, 3, 42, 13, 0, 18],
[18, 9, 5, 0, 46, 0, 0, 0, 0, 0, 0, 0, 0, 0, 0, 0, 0, 0, 0, 0, 0, 0, 0, 0, 0, 0, 0, 0, 36, 0, 0, 0, 0, 0, 0, 0, 0, 0, 0, 0, 10, 28, 21, 20, 21, 20, 21, 22, 0, 18],
[18, 14, 15, 15, 15, 15, 15, 15, 4, 0, 36, 0, 0, 0, 0, 0, 0, 0, 0, 0, 0, 0, 0, 0, 0, 0, 0, 0, 0, 0, 36, 0, 0, 0, 0, 0, 0, 0, 0, 0, 10, 13, 0, 0, 0, 0, 0, 0, 0, 18],
[18, 19, 20, 21, 21, 21, 21, 21, 22, 0, 0, 0, 0, 0, 0, 0, 0, 0, 0, 0, 0, 0, 0, 0, 0, 0, 0, 0, 0, 0, 0, 0, 0, 0, 0, 0, 0, 0, 53, 0, 10, 13, 54, 51, 46, 0, 0, 0, 0, 18],
[18, 0, 0, 0, 0, 0, 0, 0, 0, 0, 0, 0, 0, 0, 53, 0, 0, 46, 0, 0, 0, 0, 0, 0, 0, 0, 5, 0, 0, 0, 1, 2, 3, 4, 0, 0, 0, 23, 25, 25, 32, 22, 23, 24, 24, 24, 25, 26, 0, 18],
[18, 0, 0, 0, 0, 0, 0, 0, 0, 0, 0, 0, 0, 0, 1, 16, 16, 16, 16, 16, 4, 0, 0, 1, 16, 16, 16, 16, 4, 0, 0, 0, 0, 0, 0, 0, 0, 0, 0, 0, 0, 0, 0, 0, 0, 0, 0, 0, 0, 18],
[18, 0, 0, 0, 0, 0, 0, 0, 0, 0, 0, 0, 0, 0, 19, 21, 21, 21, 21, 21, 22, 0, 0, 19, 21, 21, 21, 21, 22, 0, 0, 0, 0, 0, 35, 9, 0, 0, 35, 0, 0, 0, 0, 0, 0, 0, 0, 0, 0, 18],
[18, 0, 0, 0, 0, 0, 0, 0, 0, 46, 0, 0, 53, 0, 0, 0, 0, 0, 0, 0, 0, 0, 0, 18, 0, 0, 0, 0, 0, 0, 14, 16, 16, 16, 16, 16, 16, 16, 2, 3, 4, 0, 0, 0, 0, 0, 0, 0, 0, 18],
[18, 0, 0, 0, 0, 0, 0, 23, 24, 24, 24, 25, 26, 0, 0, 0, 0, 0, 0, 0, 0, 0, 0, 27, 5, 46, 0, 0, 0, 0, 0, 0, 0, 0, 0, 0, 0, 0, 0, 0, 0, 0, 0, 9, 0, 0, 50, 0, 0, 18],
[18, 0, 0, 0, 0, 0, 0, 0, 0, 0, 0, 0, 0, 0, 0, 0, 0, 0, 0, 0, 0, 0, 0, 23, 25, 25, 25, 25, 25, 0, 0, 0, 0, 0, 0, 0, 0, 0, 0, 0, 46, 0, 1, 2, 3, 3, 17, 0, 0, 18],
[18, 47, 0, 46, 0, 53, 0, 0, 0, 0, 0, 0, 0, 0, 0, 0, 0, 0, 0, 0, 0, 0, 0, 0, 0, 0, 0, 0, 0, 0, 0, 0, 0, 0, 0, 0, 0, 0, 14, 16, 16, 16, 42, 12, 11, 12, 13, 0, 0, 18],
[18, 25, 24, 24, 25, 25, 26, 0, 0, 0, 0, 0, 0, 0, 0, 0, 0, 0, 0, 0, 0, 0, 0, 0, 0, 0, 0, 0, 0, 0, 46, 0, 0, 0, 0, 0, 0, 23, 21, 20, 21, 20, 21, 20, 20, 21, 22, 0, 53, 18],
[18, 0, 0, 0, 0, 0, 0, 0, 0, 0, 46, 0, 0, 0, 0, 0, 0, 0, 5, 1, 4, 0, 0, 14, 15, 16, 15, 16, 15, 16, 15, 16, 15, 16, 17, 0, 0, 0, 0, 0, 0, 0, 0, 0, 0, 0, 0, 0, 23, 18],
[18, 0, 0, 0, 0, 0, 0, 5, 1, 2, 3, 3, 4, 5, 0, 0, 0, 5, 1, 3, 4, 0, 0, 10, 0, 0, 0, 0, 0, 0, 0, 0, 0, 0, 0, 0, 0, 0, 0, 0, 0, 0, 0, 0, 0, 0, 0, 0, 0, 18],
[18, 5, 52, 0, 0, 50, 5, 1, 2, 3, 3, 3, 3, 17, 5, 0, 5, 1, 2, 3, 4, 0, 0, 10, 5, 48, 46, 0, 0, 0, 0, 0, 0, 46, 0, 0, 0, 0, 0, 0, 0, 0, 46, 0, 0, 0, 0, 53, 35, 18],
[31, 2, 3, 2, 3, 2, 3, 2, 3, 2, 2, 2, 2, 2, 2, 2, 2, 2, 2, 3, 4, 0, 0, 14, 2, 2, 2, 2, 2, 2, 2, 2, 2, 2, 2, 2, 2, 2, 2, 2, 2, 2, 2, 2, 2, 2, 2, 2, 3, 31],
[39, 20, 21, 21, 21, 21, 21, 21, 21, 21, 21, 21, 21, 21, 21, 21, 21, 21, 21, 21, 22, 0, 0, 19, 20, 20, 20, 20, 20, 20, 20, 20, 20, 20, 20, 20, 20, 20, 20, 20, 20, 20, 20, 20, 20, 20, 20, 20, 20, 20]
]