[
[14, 25, 25, 25, 25, 25, 25, 25, 25, 25, 25, 25, 25, 25, 25, 25, 25, 25, 25, 25, 25, 25, 25, 25, 25, 25, 25, 25, 25, 25, 25, 25, 25, 25, 25, 25, 25, 25, 25, 25, 25, 25, 25, 25, 25, 25, 25, 25, 25, 17],
[18, 0, 0, 0, 0, 0, 0, 0, 0, 0, 0, 0, 0, 0, 0, 0, 0, 0, 0, 0, 0, 0, 0, 0, 0, 0, 0, 0, 0, 0, 0, 0, 0, 0, 0, 0, 0, 0, 0, 0, 0, 0, 0, 0, 0, 0, 0, 0, 0, 18],
[18, 0, 0, 0, 0, 0, 0, 0, 0, 0, 0, 0, 0, 0, 0, 0, 0, 0, 0, 0, 0, 0, 0, 0, 0, 0, 0, 0, 0, 0, 0, 0, 0, 0, 0, 0, 0, 0, 0, 0, 0, 0, 0, 0, 0, 0, 0, 0, 0, 18],
[18, 0, 0, 0, 0, 0, 0, 0, 0, 0, 0, 0, 0, 0, 0, 0, 0, 0, 0, 0, 0, 0, 0, 0, 0, 0, 0, 0, 0, 0, 0, 0, 0, 0, 0, 0, 0, 7, 46, 51, 0, 49, 0, 46, 5, 0, 0, 0, 0, 18],
[18, 0, 0, 0, 0, 0, 0, 0, 0, 0, 0, 0, 0, 0, 0, 0, 0, 0, 0, 0, 0, 0, 0, 0, 0, 0, 0, 0, 0, 0, 0, 0, 0, 0,23, 24, 24, 24, 24, 24, 24, 25, 25, 25, 25, 26, 0, 0, 0, 18],
[18, 0, 0, 0, 0, 0, 0, 0, 0, 0, 0, 0, 0, 0, 0, 0, 0, 0, 0, 46, 0, 5, 0, 0, 0, 0, 0, 0, 0, 0, 0, 0, 0, 0, 0, 0, 0, 0, 0, 0, 0, 0, 0, 0, 0, 0, 0, 0, 0, 18],
[18, 0, 0, 0, 0, 0, 0, 0, 0, 0, 5, 46, 0, 0, 0, 0, 14, 2, 3, 2, 3, 2, 17, 0, 0, 0, 0, 0, 0, 0, 0, 0, 0, 0, 0, 0, 0, 0, 0, 0, 0, 0, 0, 0, 0, 0, 0, 54, 0, 18],
[18, 0, 0, 0, 0, 46, 49, 50, 1, 3, 2, 3, 2, 17, 0, 0, 19, 20, 21, 20, 20, 21, 22, 0, 0, 0, 0, 0, 0, 0, 0, 0, 0, 0, 0, 0, 5, 0, 0, 0, 46, 6, 0, 0, 0, 0, 1, 4, 0, 18],
[18, 0, 0, 23, 24, 25, 25, 25, 10, 11, 12, 11, 12, 13, 0, 0, 0, 0, 0, 9, 0, 0, 0, 0, 0, 0, 0, 0, 54, 0, 0, 0, 0, 1, 2, 3, 2, 3, 2, 3, 2, 3, 2, 3, 4, 0, 10, 13, 0, 18],
[18, 0, 0, 0, 0, 0, 0, 0, 19, 20, 21, 20, 21, 22, 0, 0, 0, 0, 0, 18, 0, 0, 0, 0, 0, 0, 0, 0, 36, 0, 0, 0, 0, 0, 0, 0, 0, 0, 0, 0, 0, 0, 0, 0, 0, 0, 10, 13, 0, 18],
[18, 0, 0, 0, 0, 0, 0, 0, 0, 0, 0, 0, 0, 0, 0, 0, 0, 0, 0, 18, 0, 0, 0, 0, 0, 0, 0, 0, 0, 0, 0, 0, 0, 0, 0, 0, 0, 0, 0, 0, 0, 0, 0, 0, 0, 0, 10, 13, 0, 18],
[18, 0, 0, 0, 0, 0, 0, 0, 0, 0, 0, 0, 0, 0, 0, 0, 0, 0, 0, 18, 0, 0, 0, 0, 0, 0, 0, 0, 0, 0, 0, 0, 0, 0, 0, 0, 0, 0, 0, 0, 0, 0, 0, 0, 0, 0, 10, 13, 0, 18],
[18, 0, 0, 0, 0, 0, 0, 0, 0, 0, 0, 0, 0, 0, 0, 0, 0, 0, 5, 27, 5, 51, 0, 0, 0, 0, 54, 0, 0, 0, 0, 0, 0, 0, 0, 0, 0, 0, 0, 0, 0, 5, 0, 0, 46, 7, 10, 13, 0, 18],
[18, 54, 0, 0, 0, 0, 0, 0, 0, 0, 0, 0, 0, 0, 0, 0, 23, 25, 25, 25, 25, 25, 26, 0, 0, 0, 36, 0, 0, 0, 0, 0, 0, 0, 0, 0, 0, 0, 0, 0, 1, 2, 3, 3, 2, 3, 42, 13, 0, 18],
[18, 9, 5, 0, 46, 0, 0, 0, 0, 0, 0, 0, 0, 0, 0, 0, 0, 0, 0, 0, 0, 0, 0, 0, 0, 0, 0, 0, 36, 0, 0, 0, 0, 0, 0, 0, 0, 0, 0, 0, 10, 28, 21, 20, 21, 20, 21, 22, 0, 18],
[18, 14, 15, 15, 15, 15, 15, 15, 4, 0, 36, 0, 0, 0, 0, 0, 0, 0, 0, 0, 0, 0, 0, 0, 0, 0, 0, 0, 0, 0, 36, 0, 0, 0, 0, 0, 0, 0, 0, 0, 10, 13, 0, 0, 0, 0, 0, 0, 0, 18],
[18, 19, 20, 21, 21, 21, 21, 21, 22, 0, 0, 0, 0, 0, 0, 0, 0, 0, 0, 0, 0, 0, 0, 0, 0, 0, 0, 0, 0, 0, 0, 0, 0, 0, 0, 0, 0, 0, 54, 51, 10, 13, 55, 0, 46, 0, 0, 0, 0, 18],
[18, 0, 0, 0, 0, 0, 0, 0, 0, 0, 0, 0, 0, 0, 54, 0, 0, 46, 0, 0, 0, 0, 0, 0, 0, 0, 5, 0, 0, 0, 1, 2, 3, 4, 0, 0, 0, 23, 25, 25, 32, 22, 23, 24, 24, 24, 25, 26, 0, 18],
[18, 0, 0, 0, 0, 0, 0, 0, 0, 0, 0, 0, 0, 0, 1, 16, 16, 16, 16, 16, 4, 0, 0, 1, 16, 16, 16, 16, 4, 0, 0, 0, 0, 0, 0, 0, 0, 0, 0, 0, 0, 0, 0, 0, 0, 0, 0, 0, 0, 18],
[18, 0, 0, 0, 0, 0, 0, 0, 0, 0, 0, 0, 0, 0, 19, 21, 21, 21, 21, 21, 22, 0, 0, 19, 21, 21, 21, 21, 22, 0, 0, 0, 0, 0, 35, 9, 0, 0, 35, 0, 0, 0, 0, 0, 0, 0, 0, 0, 0, 18],
[18, 0, 0, 0, 0, 0, 0, 0, 0, 46, 0, 0, 54, 0, 0, 0, 0, 0, 0, 0, 0, 0, 0, 18, 0, 0, 0, 0, 0, 0, 14, 16, 16, 16, 16, 16, 16, 16, 2, 3, 4, 0, 0, 0, 0, 0, 0, 0, 0, 18],
[18, 0, 0, 0, 0, 0, 0, 23, 24, 24, 24, 25, 26, 0, 0, 0, 0, 0, 0, 0, 0, 0, 0, 27, 5, 46, 0, 0, 0, 0, 0, 0, 0, 0, 0, 0, 0, 0, 0, 0, 0, 0, 0, 9, 0, 0, 51, 0, 0, 18],
[18, 0, 0, 0, 0, 0, 0, 0, 0, 0, 0, 0, 0, 0, 0, 0, 0, 0, 0, 0, 0, 0, 0, 23, 25, 25, 25, 25, 25, 0, 0, 0, 0, 0, 0, 0, 0, 0, 0, 0, 46, 0, 1, 2, 3, 3, 17, 0, 0, 18],
[18, 0, 0, 46, 0, 54, 0, 0, 0, 0, 0, 0, 0, 0, 0, 0, 0, 0, 0, 0, 0, 0, 0, 0, 0, 0, 0, 0, 0, 0, 0, 0, 0, 0, 0, 0, 0, 0, 14, 16, 16, 16, 42, 12, 11, 12, 13, 0, 0, 18],
[18, 25, 24, 24, 25, 25, 26, 0, 0, 0, 0, 0, 0, 0, 0, 0, 0, 0, 0, 0, 0, 0, 0, 0, 0, 0, 0, 0, 0, 0, 46, 0, 0, 0, 0, 0, 0, 23, 21, 20, 21, 20, 21, 20, 20, 21, 22, 0, 0, 18],
[18, 0, 0, 0, 0, 0, 0, 0, 0, 0, 46, 0, 0, 0, 0, 0, 0, 0, 5,1, 4, 99, 99, 14, 15, 16, 15, 16, 15, 16, 15, 16, 15, 16, 17, 0, 0, 0, 0, 0, 0, 0, 0, 0, 0, 0, 0, 0, 0, 18],
[18, 0, 0, 0, 0, 0, 0, 5, 1, 2, 3, 3, 4, 5, 0, 0, 0, 5, 1, 3, 4, 99, 99, 10, 0, 0, 0, 0, 0, 0, 0, 0, 0, 0, 0, 0, 0, 0, 0, 0, 0, 0, 0, 0, 0, 0, 0, 0, 0, 18],
[18, 5, 60, 0, 0, 0, 5, 1, 2, 3, 3, 3, 3, 17, 5, 0, 5, 1, 2,3,4, 99, 99, 10, 5, 49, 46, 0, 0, 0, 0, 0, 0, 46, 0, 0, 0, 0, 0, 0, 0, 0, 46, 0, 0, 0, 0, 6, 54, 18],
[31, 2, 3, 2, 3, 2, 3, 2, 3, 2, 2, 2, 2, 2, 2, 2, 2, 2, 2, 3, 4, 99, 99, 14, 2, 2, 2, 2, 2, 2, 2, 2, 2, 2, 2, 2, 2, 2, 2, 2, 2, 2, 2, 2, 2, 2, 2, 2, 3, 31],
[39,20,21,21,21,21,21,21,21,21, 21,21,21,21,21,21,21,21,21,21,22,99, 99, 19, 20, 20, 20, 20, 20, 20, 20, 20, 20, 20, 20, 20, 20, 20, 20, 20, 20, 20, 20, 20, 20, 20, 20, 20, 20, 20]
]