[
[9, 23, 24, 24, 24, 24, 24, 24, 24, 24, 24, 24, 24, 24, 24, 24, 24, 24, 24, 24, 24, 24, 24, 24, 24, 24, 24, 24, 24, 24, 24, 24, 24, 24, 24, 24, 24, 24, 24, 24, 24, 24, 24, 24, 24, 24, 24, 24, 24, 24, 24, 24, 24, 24, 24, 24, 24, 24, 24, 24, 24, 24, 24, 26, 9],
[18, 0, 0, 0, 0, 0, 0, 0, 0, 0, 0, 0, 0, 0, 0, 0, 0, 0, 0, 0, 0, 0, 0, 0, 0, 0, 0, 0, 0, 0, 0, 0, 0, 0, 0, 0, 0, 0, 0, 0, 0, 0, 0, 0, 0, 0, 0, 0, 0, 0, 0, 0, 0, 0, 0, 0, 0, 0, 0, 0, 0, 0, 0, 0, 18],
[18, 0, 0, 0, 0, 0, 0, 0, 0, 0, 0, 0, 0, 0, 0, 0, 0, 0, 0, 0, 0, 0, 0, 0, 0, 0, 0, 0, 0, 0, 0, 0, 0, 0, 0, 0, 0, 0, 0, 0, 0, 0, 0, 0, 0, 0, 0, 0, 0, 0, 0, 0, 0, 0, 0, 0, 0, 0, 0, 0, 0, 0, 0, 0, 18],
[18, 0, 0, 0, 0, 0, 0, 0, 0, 8, 0, 0, 5, 0, 0, 0, 7, 47, 0, 0, 6, 0, 47, 0, 8, 0, 0, 0, 47, 0, 0, 5, 0, 0, 0, 0, 0, 0, 0, 0, 5, 0, 8, 0, 0, 7, 46, 0, 0, 7, 0, 46, 0, 0, 0, 0, 0, 0, 0, 0, 0, 47, 55, 0, 18],
[18, 0, 0, 0, 0, 59, 6, 9, 23, 24, 24, 24, 24, 24, 24, 24, 24, 24, 24, 24, 24, 24, 24, 24, 24, 24, 24, 24, 24, 24, 24, 24, 24, 24, 26, 0, 0, 0, 0, 0, 23, 24, 24, 24, 24, 24, 24, 24, 24, 24, 24, 24, 24, 24, 24, 26, 0, 0, 1, 2, 2, 2, 3, 4, 18],
[18, 0, 0, 23, 24, 24, 26, 18, 0, 0, 0, 0, 0, 0, 0, 0, 0, 0, 0, 0, 0, 0, 0, 0, 0, 0, 0, 0, 0, 0, 0, 0, 0, 0, 9, 0, 0, 0, 0, 0, 0, 0, 0, 0, 0, 0, 0, 0, 0, 0, 0, 0, 0, 0, 0, 18, 0, 0, 19, 20, 20, 20, 20, 22, 18],
[18, 0, 0, 0, 0, 0, 0, 18, 0, 0, 49, 0, 0, 0, 46, 0, 0, 0, 0, 0, 0, 0, 0, 0, 0, 0, 0, 46, 0, 0, 0, 0, 59, 0, 18, 0, 0, 0, 0, 0, 0, 0, 0, 0, 0, 0, 0, 0, 0, 0, 0, 0, 0, 0, 0, 18, 0, 0, 0, 0, 0, 0, 0, 0, 18],
[18, 0, 0, 0, 0, 0, 0, 18, 0, 0, 23, 24, 24, 24, 24, 24, 24, 24, 24, 26, 0, 0, 23, 24, 24, 24, 24, 24, 24, 24, 24, 24, 26, 0, 18, 0, 0, 0, 0, 0, 0, 0, 0, 0, 0, 46, 0, 0, 0, 0, 0, 46, 0, 0, 6, 18, 0, 0, 0, 0, 0, 0, 0, 0, 18],
[18, 24, 24, 26, 0, 0, 0, 18, 5, 0, 0, 0, 0, 0, 0, 0, 0, 0, 0, 0, 0, 0, 0, 0, 0, 0, 0, 0, 0, 0, 0, 0, 0, 0, 27, 0, 0, 0, 0, 0, 23, 24, 24, 24, 24, 24, 24, 24, 24, 24, 24, 24, 24, 24, 24, 18, 54, 0, 0, 0, 0, 0, 0, 0, 18],
[18, 0, 0, 0, 0, 0, 0, 18, 26, 0, 0, 0, 0, 0, 0, 0, 0, 0, 0, 0, 0, 0, 0, 0, 0, 0, 0, 0, 0, 0, 0, 0, 0, 0, 0, 0, 0, 0, 0, 0, 0, 0, 0, 0, 0, 0, 0, 0, 0, 0, 0, 0, 0, 0, 0, 27, 14, 15, 16, 17, 0, 0, 0, 0, 18],
[18, 0, 0, 0, 0, 0, 0, 27, 5, 0, 46, 0, 0, 0, 0, 0, 0, 0, 0, 0, 0, 46, 0, 0, 0, 0, 0, 0, 0, 0, 0, 0, 0, 0, 46, 0, 0, 8, 36, 0, 0, 0, 0, 0, 0, 0, 0, 0, 0, 0, 0, 0, 0, 0, 0, 0, 0, 0, 0, 0, 0, 0, 0, 0, 18],
[18, 51, 0, 0, 54, 0, 0, 0, 24, 24, 24, 24, 24, 24, 26, 0, 0, 23, 24, 24, 24, 24, 24, 24, 24, 26, 0, 0, 23, 24, 24, 24, 24, 24, 24, 24, 24, 24, 26, 0, 0, 0, 0, 0, 0, 0, 0, 0, 0, 0, 0, 0, 0, 0, 0, 0, 0, 0, 0, 0, 0, 36, 0, 6, 18],
[18, 24, 24, 24, 24, 26, 0, 0, 0, 0, 0, 0, 0, 0, 0, 0, 0, 0, 0, 0, 0, 0, 0, 0, 0, 0, 0, 0, 0, 0, 0, 0, 0, 0, 0, 0, 0, 0, 0, 0, 0, 0, 0, 0, 0, 0, 0, 0, 46, 0, 0, 0, 0, 0, 46, 0, 0, 0, 0, 23, 24, 24, 24, 26, 18],
[18, 0, 0, 0, 0, 0, 0, 0, 0, 0, 0, 0, 0, 0, 0, 0, 0, 0, 0, 0, 0, 0, 0, 0, 0, 0, 0, 0, 0, 0, 0, 0, 0, 0, 0, 0, 0, 0, 0, 0, 0, 0, 0, 0, 0, 9, 23, 24, 24, 24, 24, 24, 24, 24, 24, 24, 26, 0, 0, 0, 0, 0, 0, 0, 18],
[18, 0, 0, 0, 0, 0, 0, 9, 51, 49, 0, 0, 0, 0, 0, 0, 0, 0, 0, 0, 0, 0, 0, 0, 0, 0, 0, 0, 0, 0, 0, 0, 0, 0, 0, 0, 0, 0, 0, 0, 0, 0, 0, 0, 0, 18, 0, 0, 0, 0, 0, 0, 0, 0, 0, 0, 0, 0, 0, 0, 0, 0, 0, 0, 18],
[18, 0, 0, 23, 24, 24, 25, 18, 25, 24, 24, 24, 24, 24, 24, 24, 24, 24, 24, 24, 24, 26, 9, 0, 0, 0, 0, 0, 0, 0, 0, 0, 0, 0, 0, 0, 0, 0, 0, 0, 0, 0, 0, 0, 23, 18, 0, 0, 0, 0, 0, 0, 0, 0, 0, 0, 0, 0, 0, 0, 0, 0, 0, 6, 18],
[18, 0, 0, 0, 0, 0, 0, 18, 0, 0, 0, 0, 0, 0, 0, 0, 0, 0, 0, 0, 0, 0, 18, 5, 0, 0, 0, 0, 0, 0, 0, 0, 0, 0, 0, 0, 0, 0, 0, 0, 0, 0, 0, 0, 0, 18, 0, 0, 46, 0, 0, 0, 0, 0, 0, 0, 0, 0, 14, 16, 15, 16, 15, 16, 18],
[18, 36, 7, 0, 0, 0, 0, 18, 0, 0, 0, 47, 0, 0, 0, 0, 47, 0, 50, 0, 59, 0, 18, 26, 0, 0, 0, 0, 0, 0, 0, 0, 0, 0, 0, 0, 0, 0, 0, 0, 0, 0, 0, 0, 0, 18, 23, 25, 25, 24, 24, 24, 26, 0, 0, 0, 0, 0, 19, 20, 21, 20, 21, 20, 18],
[18, 14, 15, 16, 17, 0, 0, 18, 0, 0, 23, 25, 25, 25, 25, 25, 25, 25, 25, 26, 9, 0, 18, 0, 0, 0, 0, 0, 46, 0, 0, 0, 0, 0, 0, 0, 0, 0, 0, 0, 0, 0, 0, 0, 0, 18, 23, 25, 25, 25, 25, 25, 26, 0, 0, 23, 26, 0, 0, 0, 0, 0, 0, 0, 18],
[18, 0, 0, 0, 0, 0, 0, 18, 0, 0, 0, 0, 0, 0, 0, 0, 0, 0, 0, 0, 18, 0, 18, 0, 0, 23, 24, 24, 24, 24, 24, 24, 26, 0, 0, 0, 0, 0, 0, 5, 0, 46, 0, 54, 0, 27, 0, 0, 0, 0, 0, 0, 0, 0, 0, 0, 0, 0, 0, 0, 0, 0, 0, 0, 18],
[18, 0, 0, 0, 0, 6, 36, 18, 36, 6, 0, 0, 47, 0, 0, 0, 0, 0, 0, 0, 18, 0, 18, 5, 0, 0, 0, 0, 0, 0, 0, 0, 0, 0, 0, 23, 24, 24, 24, 24, 24, 24, 24, 24, 24, 26, 0, 0, 0, 0, 0, 0, 0, 0, 0, 0, 0, 0, 0, 0, 0, 0, 0, 49, 18],
[18, 0, 0, 14, 15, 16, 17, 18, 23, 24, 24, 24, 24, 24, 24, 24, 26, 0, 0, 0, 18, 0, 18, 26, 0, 0, 0, 5, 0, 0, 0, 0, 0, 0, 0, 0, 0, 0, 0, 0, 0, 0, 0, 0, 0, 0, 0, 0, 0, 0, 0, 0, 0, 0, 0, 0, 24, 24, 24, 24, 24, 24, 24, 26, 18],
[18, 0, 0, 0, 0, 0, 0, 18, 0, 0, 0, 0, 0, 0, 0, 0, 0, 0, 0, 0, 18, 0, 18, 0, 0, 23, 24, 24, 24, 24, 24, 24, 26, 0, 0, 0, 0, 0, 0, 0, 0, 0, 0, 0, 0, 0, 0, 0, 0, 0, 0, 0, 0, 0, 0, 0, 18, 0, 0, 0, 0, 0, 0, 0, 18],
[18, 36, 6, 0, 0, 0, 0, 18, 0, 0, 0, 0, 0, 0, 47, 0, 0, 8, 36, 51, 18, 0, 18, 0, 0, 0, 0, 0, 0, 0, 0, 0, 0, 0, 0, 23, 24, 24, 24, 24, 24, 24, 24, 26, 9, 0, 0, 0, 0, 0, 0, 0, 0, 0, 0, 0, 18, 0, 0, 46, 0, 0, 0, 0, 18],
[18, 16, 15, 4, 0, 0, 0, 18, 0, 23, 24, 24, 24, 24, 24, 24, 24, 24, 24, 26, 27, 0, 18, 36, 0, 49, 0, 0, 0, 0, 0, 0, 0, 0, 0, 18, 0, 0, 0, 0, 0, 0, 0, 0, 18, 0, 0, 0, 0, 46, 0, 0, 0, 0, 0, 0, 18, 6, 0, 0, 0, 0, 0, 0, 18],
[18, 0, 0, 0, 0, 0, 6, 18, 0, 0, 0, 0, 0, 0, 0, 0, 0, 0, 0, 0, 0, 0, 18, 23, 24, 24, 24, 24, 26, 0, 0, 0, 0, 0, 0, 18, 0, 0, 0, 0, 0, 0, 0, 0, 18, 0, 0, 23, 24, 24, 24, 24, 24, 24, 26, 0, 27, 23, 24, 24, 24, 26, 0, 0, 18],
[18, 0, 0, 0, 0, 1, 16, 27, 54, 0, 46, 6, 0, 0, 0, 0, 0, 46, 0, 0, 0, 0, 18, 23, 24, 24, 24, 24, 24, 26, 0, 0, 0, 0, 0, 18, 0, 0, 0, 0, 0, 0, 0, 0, 18, 0, 0, 0, 0, 0, 0, 0, 0, 0, 0, 0, 0, 0, 0, 0, 0, 0, 0, 0, 18],
[18, 0, 0, 0, 0, 0, 0, 23, 24, 24, 24, 24, 24, 24, 24, 24, 24, 24, 24, 24, 26, 0, 18, 23, 24, 24, 24, 24, 24, 25, 26, 0, 0, 0, 54, 18, 59, 59, 46, 0, 0, 0, 0, 0, 18, 0, 0, 0, 0, 0, 0, 0, 0, 0, 0, 0, 0, 0, 0, 0, 0, 0, 6, 36, 18],
[18, 6, 0, 0, 0, 0, 0, 0, 0, 0, 0, 0, 0, 0, 0, 0, 0, 0, 0, 0, 0, 0, 18, 23, 24, 24, 24, 24, 24, 24, 24, 24, 24, 24, 24, 27, 25, 25, 25, 25, 26, 0, 0, 0, 27, 54, 0, 0, 0, 0, 0, 0, 0, 0, 0, 23, 24, 24, 24, 24, 24, 24, 24, 26, 18],
[18, 16, 15, 4, 0, 0, 0, 0, 0, 0, 0, 46, 0, 0, 0, 0, 46, 0, 0, 0, 0, 54, 27, 0, 0, 0, 0, 0, 0, 0, 0, 0, 0, 0, 0, 0, 0, 0, 0, 0, 0, 0, 0, 0, 23, 24, 24, 24, 24, 24, 26, 0, 0, 0, 0, 0, 0, 0, 0, 0, 0, 0, 0, 0, 18],
[18, 0, 0, 0, 0, 0, 23, 24, 24, 24, 24, 24, 24, 24, 24, 24, 24, 25, 25, 25, 25, 25, 26, 0, 0, 0, 0, 0, 0, 0, 0, 0, 0, 0, 0, 0, 0, 0, 0, 0, 0, 0, 0, 0, 0, 0, 0, 0, 0, 0, 0, 0, 0, 0, 0, 0, 0, 0, 0, 0, 0, 0, 0, 0, 18],
[18, 0, 57, 0, 0, 0, 0, 0, 0, 0, 0, 0, 0, 0, 0, 0, 0, 0, 0, 0, 0, 0, 0, 0, 0, 0, 0, 0, 0, 0, 0, 0, 0, 0, 0, 0, 0, 0, 0, 0, 0, 0, 54, 0, 0, 0, 0, 0, 0, 0, 0, 0, 0, 0, 0, 0, 0, 0, 0, 0, 0, 0, 0, 0, 18],
[18, 25, 25, 25, 26, 0, 0, 0, 0, 0, 0, 0, 0, 0, 0, 0, 0, 0, 0, 0, 0, 0, 0, 0, 0, 23, 24, 24, 24, 24, 24, 24, 24, 24, 24, 24, 24, 24, 24, 24, 24, 24, 24, 24, 24, 26, 9, 0, 0, 0, 0, 0, 54, 0, 46, 0, 0, 0, 0, 0, 0, 0, 0, 0, 18],
[18, 0, 0, 0, 0, 0, 0, 0, 0, 0, 0, 0, 0, 0, 0, 0, 0, 0, 0, 0, 0, 0, 0, 0, 5, 18, 0, 0, 0, 0, 0, 0, 0, 0, 0, 0, 0, 0, 0, 0, 0, 0, 0, 0, 0, 0, 18, 0, 0, 0, 0, 0, 23, 24, 24, 24, 24, 26, 0, 0, 0, 0, 0, 0, 18],
[18, 0, 0, 0, 0, 0, 0, 0, 5, 46, 0, 0, 0, 0, 0, 0, 0, 0, 0, 46, 5, 0, 0, 0, 36, 18, 0, 0, 0, 0, 0, 0, 0, 0, 0, 0, 0, 0, 0, 0, 0, 0, 0, 0, 0, 0, 18, 0, 0, 0, 0, 0, 0, 0, 0, 0, 0, 0, 0, 0, 0, 0, 0, 0, 18],
[18, 0, 0, 0, 6, 1, 2, 2, 2, 2, 2, 2, 4, 0, 0, 1, 2, 3, 2, 3, 2, 3, 4, 0, 0, 18, 49, 0, 51, 0, 46, 0, 6, 9, 0, 0, 0, 0, 0, 9, 6, 0, 46, 0, 59, 59, 18, 0, 0, 0, 0, 0, 0, 0, 0, 0, 0, 6, 0, 36, 0, 0, 59, 51, 18],
[18, 0, 0, 0, 1, 42, 28, 21, 20, 21, 20, 21, 22, 0, 0, 19, 20, 21, 20, 21, 20, 21, 22, 0, 0, 18, 23, 25, 25, 25, 25, 25, 25, 26, 0, 0, 0, 0, 0, 23, 25, 25, 25, 25, 25, 25, 27, 0, 0, 0, 0, 1, 2, 2, 4, 0, 0, 36, 0, 0, 0, 0, 14, 17, 18],
[18, 60, 0, 6, 10, 11, 13, 0, 0, 0, 0, 0, 0, 0, 0, 0, 0, 0, 0, 0, 0, 0, 0, 0, 0, 18, 0, 0, 0, 0, 0, 0, 0, 0, 0, 0, 0, 0, 0, 0, 0, 0, 0, 0, 0, 0, 0, 0, 0, 0, 1, 2, 2, 2, 4, 0, 0, 0, 0, 0, 0, 14, 15, 17, 18],
[18, 6, 0, 1, 42, 11, 13, 49, 0, 6, 0, 0, 0, 54, 0, 0, 46, 0, 5, 0, 0, 0, 0, 0, 6, 27, 6, 0, 0, 46, 0, 0, 0, 6, 0, 0, 54, 0, 0, 46, 0, 0, 7, 0, 0, 0, 0, 0, 0, 14, 15, 16, 15, 15, 4, 6, 0, 46, 0, 6, 14, 15, 16, 17, 27],
[27, 2, 2, 2, 2, 2, 2, 2, 2, 2, 2, 2, 2, 2, 2, 2, 2, 2, 2, 2, 2, 2, 2, 2, 2, 2, 2, 2, 2, 2, 2, 2, 2, 2, 2, 2, 2, 2, 2, 2, 2, 2, 2, 2, 2, 2, 2, 2, 2, 2, 2, 2, 2, 2, 2, 2, 2, 2, 2, 2, 2, 2, 2, 2, 4]
        ]